#########################################################################################################################
#                                                                                                                       #
#                                                                                                                       #
#                                                                                                                       #
#                                                                                                                       #
#                                                                                                                       #
#                                                                                                                       #
#                                       ########################################                                        #
#                                       ##                         ##         ##                                        #
#                                       ##                         ##         ##                                        #
#                                       ##            B            ##    D    ##                                        #
#                                       ##                         ##         ##                                        #
#                                       ##                         ##         ##                                        #
#                                       ##                         ##         ##                                        #
#                                       ##                                    ##                                        #
#                                       ##                                    ##                                        #
#                                       ##                                    ##                                        #
#                                       ##                                    ##                                        #
#                                       ##                                    ##                                        #
#                                       ################### ####################                                        #
#                                       ###################Ï####################                                        #
#                                                                                                                       #
#                                                                                                                       #
#                                                                                                                       #
#                                                                                                                       #
#                                                                                                                       #
#                                                                                                                       #
#                                                                                                                       #
#                                                                                                                       #
#########################################################################################################################