########################################################################################################################
#          #                                                                                                            #
#         #                                                                                                             #
#                                                                                                                      #
#                                                                                                                      #
#                                                                                                                      #
#                                                                                                                      #
#                                                                                                                      #
#                                                                                                                      #
#                                                                                                                      #
#                                                                                                                      #
#                                                                                                                      #
#                                                                                                                      #
#                                                                                                                      #
#                                                                                                                      #
#                                                                                                                      #
#                                                                                                                      #
#                                                                                                                      #
#                                                                                                                      #
#                                                                                                                      #
#                                                                                                                      #
#                                                                                                                      #
#                                                                                                                      #
#                                                                                                                      #
#                                                                                                                      #
#                                                                                                                      #
#                                                                                                                      #
#                                                                                                                      #
#                                                                                                                      #
#                                                                                                                      #
########################################################################################################################